Il Mulino Prime	  Mon–Fri: Lunch, Dinner  |  Sun: Brunch/Lunch, Dinner 
Giorgio's of Gramercy	  Mon–Fri: Lunch, Dinner  | Sun Dinner
Bar Italia	  Mon–Fri: Lunch, Dinner 
Fogo de Chão Churrascaria Brazilian Steakhouse	 Mon-Fri Dinner
Nobu New York	 Mon-Fri Lunch
Clement	  Mon–Fri: Lunch, Dinner 
Sessanta Ristorante	 Mon-Fri Dinner |  Sun: Brunch/Lunch, Dinner 
Tavern62 by David Burke	 Mon-Fri Lunch
Beautique	 Mon-Fri Dinner
Koi SoHo	  Mon–Fri: Lunch, Dinner  |  Sun: Brunch/Lunch, Dinner 
La Fonda Del Sol	  Mon–Fri: Lunch, Dinner 
Il Mulino New York (Uptown)	 Mon-Fri Lunch | Sun Brunch/Lunch
Riverpark	  Mon–Fri: Lunch, Dinner  | Sun Dinner
Mr. Chow New York - 57th Street	 Mon-Fri Dinner | Sun Dinner
NYY Steak—Manhattan	  Mon–Fri: Lunch, Dinner 
Rock Center Café	  Mon–Fri: Lunch, Dinner 
The Leopard at des Artistes	 Mon-Fri Dinner |  Sun: Brunch/Lunch, Dinner 
The Capital Grille Wall Street	  Mon–Fri: Lunch, Dinner 
Craft Restaurant	 Mon-Fri Lunch
Charlie Palmer Steak	  Mon–Fri: Lunch, Dinner 
Socarrat Paella Bar - Chelsea	  Mon–Fri: Lunch, Dinner  |  Sun: Brunch/Lunch, Dinner 
Lincoln Ristorante	 Mon-Fri Lunch | Sun Brunch/Lunch
Rosa Mexicano–Tribeca	  Mon–Fri: Lunch, Dinner  |  Sun: Brunch/Lunch, Dinner 
Tamarind Tribeca	 Mon-Fri Lunch | Sun Brunch/Lunch
Maya	 Mon-Fri Dinner | Sun Dinner
Bull and Bear Prime Steakhouse	 Mon-Fri Dinner | Sun Dinner
Dos Caminos Third Avenue	  Mon–Fri: Lunch, Dinner 
Noreetuh	 Mon-Fri Dinner | Sun Dinner
Empellón Cocina	 Mon-Fri Dinner
American Cut—Tribeca	 Mon-Fri Dinner
Blenheim	 Mon-Fri Dinner | Sun Dinner
American Cut (Midtown)	 Mon-Fri Dinner
Maysville	 Mon-Fri Lunch |  Sun: Brunch/Lunch, Dinner 
Bread & Tulips	  Mon–Fri: Lunch, Dinner 
Trattoria Il Mulino	  Mon–Fri: Lunch, Dinner  |  Sun: Brunch/Lunch, Dinner 
Virginia's	 Mon-Fri Dinner
Khe-Yo	  Mon–Fri: Lunch, Dinner  |  Sun: Brunch/Lunch, Dinner 
Anassa Taverna	  Mon–Fri: Lunch, Dinner  | Sun Dinner
Tuome	 Mon-Fri Dinner | Sun Dinner
Asellina	  Mon–Fri: Lunch, Dinner  |  Sun: Brunch/Lunch, Dinner 
Socarrat Paella Bar - Nolita	 Mon-Fri Dinner |  Sun: Brunch/Lunch, Dinner 
Crossroads American Kitchen and Bar	  Mon–Fri: Lunch, Dinner 
Capri Ristorante	  Mon–Fri: Lunch, Dinner  |  Sun: Brunch/Lunch, Dinner 
Match 65 Brasserie	  Mon–Fri: Lunch, Dinner  |  Sun: Brunch/Lunch, Dinner 
Nobu Next Door	 Mon-Fri Dinner | Sun Dinner
Fung Tu	 Mon-Fri Dinner
Smoke Jazz & Supper Club	 Mon-Fri Dinner | Sun Brunch/Lunch
Minton’s	 Mon-Fri Dinner |  Sun: Brunch/Lunch, Dinner 
Ai Fiori	 Mon-Fri Lunch
Lincoln Square Steak	 Mon-Fri Dinner | Sun Dinner
ABC Kitchen	 Mon-Fri Lunch
French Louie	  Mon–Fri: Lunch, Dinner 
Obao Hell's Kitchen	  Mon–Fri: Lunch, Dinner 
Green Fig	 Mon-Fri Dinner | Sun Dinner
Empire Steak House - West 54th Street	  Mon–Fri: Lunch, Dinner  |  Sun: Brunch/Lunch, Dinner 
Casa Nonna	  Mon–Fri: Lunch, Dinner  | Sun Dinner
Atlantic Grill at Lincoln Center	  Mon–Fri: Lunch, Dinner 
Dos Caminos Park Avenue	  Mon–Fri: Lunch, Dinner 
Bo's Kitchen & Bar Room	  Mon–Fri: Lunch, Dinner 
Scarpetta	 Mon-Fri Dinner | Sun Dinner
Pershing Square	 Mon-Fri Dinner | Sun Dinner
The View Restaurant & Lounge	 Mon-Fri Dinner
Edi & the Wolf	 Mon-Fri Dinner | Sun Dinner
Aretsky's Patroon	 Mon-Fri Dinner
Morton's The Steakhouse—Manhattan	  Mon–Fri: Lunch, Dinner  | Sun Dinner
Altesi Ristorante	 Mon-Fri Lunch |  Sun: Brunch/Lunch, Dinner 
Tertulia	  Mon–Fri: Lunch, Dinner  |  Sun: Brunch/Lunch, Dinner 
Haru Chelsea	  Mon–Fri: Lunch, Dinner 
Dos Caminos SoHo	  Mon–Fri: Lunch, Dinner 
Kefi	  Mon–Fri: Lunch, Dinner  |  Sun: Brunch/Lunch, Dinner 
Sutton Inn	 Mon-Fri Dinner
Il Mulino New York (Downtown)	 Mon-Fri Lunch
Chazz Palminteri Ristorante Italiano	  Mon–Fri: Lunch, Dinner  |  Sun: Brunch/Lunch, Dinner 
Circo	  Mon–Fri: Lunch, Dinner  | Sun Dinner
Sant Ambroeus SoHo	 Mon-Fri Dinner | Sun Dinner
Frankie & Johnnie's Steakhouse—46th Street	  Mon–Fri: Lunch, Dinner  | Sun Dinner
State Grill and Bar	  Mon–Fri: Lunch, Dinner 
Haru Gramercy Park	  Mon–Fri: Lunch, Dinner 
Sarabeth's Tribeca	  Mon–Fri: Lunch, Dinner  | Sun Dinner
Etcetera Etcetera	  Mon–Fri: Lunch, Dinner  |  Sun: Brunch/Lunch, Dinner 
Blue Water Grill	  Mon–Fri: Lunch, Dinner 
Irvington	  Mon–Fri: Lunch, Dinner  | Sun Dinner
Beauty & Essex	 Mon-Fri Dinner | Sun Dinner
Rosa Mexicano—First Avenue	  Mon–Fri: Lunch, Dinner  |  Sun: Brunch/Lunch, Dinner 
Montebello Restaurant	  Mon–Fri: Lunch, Dinner 
Molyvos Restaurant	  Mon–Fri: Lunch, Dinner  |  Sun: Brunch/Lunch, Dinner 
Indochine	 Mon-Fri Dinner | Sun Dinner
Dos Caminos Times Square	  Mon–Fri: Lunch, Dinner 
The Sea Grill	 Mon-Fri Dinner
The National Bar & Dining Rooms	 Mon-Fri Dinner | Sun Dinner
Docks Oyster Bar	  Mon–Fri: Lunch, Dinner  |  Sun: Brunch/Lunch, Dinner 
Lure Fishbar	  Mon–Fri: Lunch, Dinner  | Sun Dinner
Leuca	 Mon-Fri Lunch
Mamo Restaurant	  Mon–Fri: Lunch, Dinner  |  Sun: Brunch/Lunch, Dinner 
Ted's Montana Grill	 Mon-Fri Dinner | Sun Dinner
Morton's The Steakhouse—World Trade Center	  Mon–Fri: Lunch, Dinner  | Sun Dinner
Stella 34 Trattoria	 Mon-Fri Lunch | Sun Dinner
Sarabeth's Upper West Side	  Mon–Fri: Lunch, Dinner  | Sun Dinner
Vaucluse	 Mon-Fri Lunch
Essex	 Mon-Fri Dinner | Sun Dinner
The John Dory Oyster Bar	  Mon–Fri: Lunch, Dinner  |  Sun: Brunch/Lunch, Dinner 
Gaby Brasserie Française	  Mon–Fri: Lunch, Dinner  |  Sun: Brunch/Lunch, Dinner 
Bagatelle	  Mon–Fri: Lunch, Dinner  | Sun Dinner
La Pecora Bianca	  Mon–Fri: Lunch, Dinner  | Sun Dinner
ilili Restaurant	  Mon–Fri: Lunch, Dinner 
The Shakespeare	  Mon–Fri: Lunch, Dinner 
Mulino a Vino	 Mon-Fri Dinner |  Sun: Brunch/Lunch, Dinner 
Vandal	 Mon-Fri Dinner | Sun Dinner
Rowland's Bar & Grill	 Mon-Fri Lunch | Sun Brunch/Lunch
Limani	  Mon–Fri: Lunch, Dinner  |  Sun: Brunch/Lunch, Dinner 
La Sirene	  Mon–Fri: Lunch, Dinner  |  Sun: Brunch/Lunch, Dinner 
Church & Dey	  Mon–Fri: Lunch, Dinner  |  Sun: Brunch/Lunch, Dinner 
Fonda	 Mon-Fri Dinner | Sun Dinner
Churrascaria Plataforma Brazilian Steakhouse	 Mon-Fri Lunch
The Breslin Bar & Dining Room	  Mon–Fri: Lunch, Dinner  |  Sun: Brunch/Lunch, Dinner 
SushiSamba West Village	  Mon–Fri: Lunch, Dinner  |  Sun: Brunch/Lunch, Dinner 
Zuma	 Mon-Fri Lunch | Sun Brunch/Lunch
'21' Club	  Mon–Fri: Lunch, Dinner 
Catch NYC	 Mon-Fri Dinner |  Sun: Brunch/Lunch, Dinner 
Sant Ambroeus—West Village	  Mon–Fri: Lunch, Dinner  | Sun Dinner
Triomphe Restaurant	  Mon–Fri: Lunch, Dinner 
Aureole - Liberty Room	  Mon–Fri: Lunch, Dinner 
Blue Fin	  Mon–Fri: Lunch, Dinner 
Tao Uptown	 Mon-Fri Lunch
Asia de Cuba	 Mon-Fri Dinner
Junoon	  Mon–Fri: Lunch, Dinner  |  Sun: Brunch/Lunch, Dinner 
Michael Jordan's The Steak House N.Y.C.	  Mon–Fri: Lunch, Dinner  |  Sun: Brunch/Lunch, Dinner 
The Red Cat	  Mon–Fri: Lunch, Dinner  |  Sun: Brunch/Lunch, Dinner 
La Loteria	  Mon–Fri: Lunch, Dinner  | Sun Dinner
Brasserie Ruhlmann	 Mon-Fri Dinner
Kingside	 Mon-Fri Dinner | Sun Dinner
Tao Downtown	 Mon-Fri Dinner | Sun Dinner
Glass House Tavern	  Mon–Fri: Lunch, Dinner  |  Sun: Brunch/Lunch, Dinner 
Felice 15 Gold Street	  Mon–Fri: Lunch, Dinner  |  Sun: Brunch/Lunch, Dinner 
Smörgås Chef	  Mon–Fri: Lunch, Dinner  | Sun Brunch/Lunch
Le Colonial	  Mon–Fri: Lunch, Dinner  | Sun Dinner
David Burke Kitchen	  Mon–Fri: Lunch, Dinner  |  Sun: Brunch/Lunch, Dinner 
Kellari Taverna	  Mon–Fri: Lunch, Dinner  |  Sun: Brunch/Lunch, Dinner 
The Capital Grille Time Life	  Mon–Fri: Lunch, Dinner  | Sun Dinner
Naples 45 Ristorante e Pizzeria	 Mon-Fri Dinner
Barbounia	  Mon–Fri: Lunch, Dinner  | Sun Dinner
Lexington Brass	  Mon–Fri: Lunch, Dinner  |  Sun: Brunch/Lunch, Dinner 
Felice 83	  Mon–Fri: Lunch, Dinner  | Sun Dinner
Obicà Mozzarella Bar Pizza e Cucina	  Mon–Fri: Lunch, Dinner  | Sun Dinner
Isabella's	  Mon–Fri: Lunch, Dinner 
Barbetta	  Mon–Fri: Lunch, Dinner 
Pera Mediterranean Brasserie	  Mon–Fri: Lunch, Dinner  | Sun Dinner
Southgate Bar & Restaurant	  Mon–Fri: Lunch, Dinner  | Sun Dinner
Charlie Palmer at the Knick	  Mon–Fri: Lunch, Dinner  |  Sun: Brunch/Lunch, Dinner 
City Crab Shack	  Mon–Fri: Lunch, Dinner  |  Sun: Brunch/Lunch, Dinner 
Rosa Mexicano—Lincoln Center	  Mon–Fri: Lunch, Dinner  |  Sun: Brunch/Lunch, Dinner 
HanGawi	 Mon-Fri Lunch
Gran Morsi	  Mon–Fri: Lunch, Dinner  | Sun Dinner
The Stanton Social	 Mon-Fri Dinner | Sun Dinner
China Grill	  Mon–Fri: Lunch, Dinner  |  Sun: Brunch/Lunch, Dinner 
Burke & Wills	  Mon–Fri: Lunch, Dinner  | Sun Dinner
Bar Primi	  Mon–Fri: Lunch, Dinner  | Sun Dinner
Inakaya New York	 Mon-Fri Dinner | Sun Dinner
Dos Caminos Meatpacking District	  Mon–Fri: Lunch, Dinner 
Victor's Cafe	 Mon-Fri Lunch
Salvation Taco	 Mon-Fri Lunch | Sun Brunch/Lunch
Tribeca Grill	  Mon–Fri: Lunch, Dinner  |  Sun: Brunch/Lunch, Dinner 
Buttermilk Channel	  Mon–Fri: Lunch, Dinner 
El Toro Blanco	  Mon–Fri: Lunch, Dinner  | Sun Dinner
Ed's Chowder House	 Mon-Fri Dinner | Sun Dinner
Casa Lever	 Mon-Fri Dinner
Nick & Stef’s Steakhouse	 Mon-Fri Lunch
Bann	  Mon–Fri: Lunch, Dinner  |  Sun: Brunch/Lunch, Dinner 
Ammos Estiatorio - Grand Central	 Mon-Fri Dinner
The Gander	  Mon–Fri: Lunch, Dinner 
E&E Grill House	  Mon–Fri: Lunch, Dinner  |  Sun: Brunch/Lunch, Dinner 
Schilling	  Mon–Fri: Lunch, Dinner 
Empire Steak House - East 50th Street	  Mon–Fri: Lunch, Dinner  |  Sun: Brunch/Lunch, Dinner 
ABC Cocina	 Mon-Fri Lunch
Tarallucci e Vino—Union Square	  Mon–Fri: Lunch, Dinner  | Sun Brunch/Lunch
Tender Steak & Sushi	  Mon–Fri: Lunch, Dinner 
Café Centro	  Mon–Fri: Lunch, Dinner 
Tavern on the Green	  Mon–Fri: Lunch, Dinner  | Sun Dinner
Haru Amsterdam Avenue	 Mon-Fri Dinner
The Wayfarer	 Mon-Fri Lunch
Amada	  Mon–Fri: Lunch, Dinner  |  Sun: Brunch/Lunch, Dinner 
Felidia	 Mon-Fri Lunch
Strip House Midtown	 Mon-Fri Lunch
Hunt & Fish Club NYC	 Mon-Fri Lunch | Sun Dinner
Mr. Chow New York - Tribeca	 Mon-Fri Dinner | Sun Dinner
Freud NYC	  Mon–Fri: Lunch, Dinner  | Sun Dinner
La Chine	 Mon-Fri Dinner
Toloache	  Mon–Fri: Lunch, Dinner  |  Sun: Brunch/Lunch, Dinner 
El Vez	  Mon–Fri: Lunch, Dinner 
Socarrat Paella Bar - East	  Mon–Fri: Lunch, Dinner  |  Sun: Brunch/Lunch, Dinner 
Black Barn Restaurant	 Mon-Fri Lunch
Fig & Olive—Uptown	  Mon–Fri: Lunch, Dinner  |  Sun: Brunch/Lunch, Dinner 
Rosa Mexicano—Union Square	  Mon–Fri: Lunch, Dinner  |  Sun: Brunch/Lunch, Dinner 
Atlantic Grill East Side	  Mon–Fri: Lunch, Dinner 
Raymi Restaurant	 Mon-Fri Dinner |  Sun: Brunch/Lunch, Dinner 
BKW by Brooklyn Winery	 Mon-Fri Dinner | Sun Dinner
Orsay Restaurant	  Mon–Fri: Lunch, Dinner  | Sun Dinner
The Morgan Dining Room	 Mon-Fri Lunch
Toloache Thompson	  Mon–Fri: Lunch, Dinner  |  Sun: Brunch/Lunch, Dinner 
Members Dining Room at the Met Museum	 Mon-Fri Lunch
Ristorante Morini	 Mon-Fri Lunch
The Palm Court	 Mon-Fri Dinner
Davio's Northern Italian Steakhouse	  Mon–Fri: Lunch, Dinner  | Sun Dinner
Gaonnuri	  Mon–Fri: Lunch, Dinner  | Sun Dinner
Barraca	  Mon–Fri: Lunch, Dinner  | Sun Dinner
Gabriel's Bar & Restaurant	  Mon–Fri: Lunch, Dinner 
Il Postino	  Mon–Fri: Lunch, Dinner  | Sun Dinner
Sofrito on the Hudson	 Mon-Fri Dinner | Sun Dinner
Morimoto NY	 Mon-Fri Lunch
Zengo	  Mon–Fri: Lunch, Dinner 
Claudette	  Mon–Fri: Lunch, Dinner  | Sun Dinner
The Library at The Public	 Mon-Fri Dinner | Sun Dinner
Ben & Jack's Steakhouse on 5th	  Mon–Fri: Lunch, Dinner  |  Sun: Brunch/Lunch, Dinner 
Brasserie Séoul	  Mon–Fri: Lunch, Dinner  | Sun Dinner
Ocean Prime	 Mon-Fri Dinner | Sun Dinner
Delmonico's Restaurant	  Mon–Fri: Lunch, Dinner 
Estiatorio Milos	 Mon-Fri Lunch | Sun Brunch/Lunch
Il Buco Alimentari & Vineria	  Mon–Fri: Lunch, Dinner  |  Sun: Brunch/Lunch, Dinner 
Fig & Olive—Midtown	  Mon–Fri: Lunch, Dinner  |  Sun: Brunch/Lunch, Dinner 
Macondo West	 Mon-Fri Dinner | Sun Dinner
Chefs Club	 Mon-Fri Dinner | Sun Dinner
Root & Bone	  Mon–Fri: Lunch, Dinner  |  Sun: Brunch/Lunch, Dinner 
Le Périgord	  Mon–Fri: Lunch, Dinner  | Sun Dinner
Delmonico's Kitchen	  Mon–Fri: Lunch, Dinner  | Sun Dinner
Brasserie 8 1/2	  Mon–Fri: Lunch, Dinner  | Sun Dinner
Butter Midtown	  Mon–Fri: Lunch, Dinner 
Giovanni Rana Pastificio & Cucina	 Mon-Fri Dinner | Sun Dinner
Cipriani Wall Street	  Mon–Fri: Lunch, Dinner 
STK Midtown	  Mon–Fri: Lunch, Dinner  | Sun Dinner
Neta	 Mon-Fri Dinner
Perry Street	  Mon–Fri: Lunch, Dinner  | Sun Dinner
Brasserie Cognac	  Mon–Fri: Lunch, Dinner  |  Sun: Brunch/Lunch, Dinner 
STK Downtown	 Mon-Fri Dinner | Sun Dinner
Auden Bistro & Bar	  Mon–Fri: Lunch, Dinner  | Sun Dinner
Ruth's Chris Steak House	  Mon–Fri: Lunch, Dinner  | Sun Dinner
Amma Restaurant	  Mon–Fri: Lunch, Dinner  |  Sun: Brunch/Lunch, Dinner 
Darbar	 Mon-Fri Dinner | Sun Dinner
Gotham Bar & Grill	 Mon-Fri Lunch
The Capital Grille Chrysler Center	  Mon–Fri: Lunch, Dinner  | Sun Dinner
Lavo Restaurant	  Mon–Fri: Lunch, Dinner 
Lido	  Mon–Fri: Lunch, Dinner 
The Russian Tea Room	  Mon–Fri: Lunch, Dinner 
Il Riccio	  Mon–Fri: Lunch, Dinner  |  Sun: Brunch/Lunch, Dinner 
The Greenhouse Cafe	  Mon–Fri: Lunch, Dinner  |  Sun: Brunch/Lunch, Dinner 
Andanada	 Mon-Fri Dinner |  Sun: Brunch/Lunch, Dinner 
Hakkasan New York	 Mon-Fri Dinner | Sun Dinner
Natsumi	 Mon-Fri Dinner | Sun Dinner
North Square Restaurant & Lounge	  Mon–Fri: Lunch, Dinner  | Sun Dinner
Sazón	  Mon–Fri: Lunch, Dinner  | Sun Dinner
Tommy Bahama Restaurant–Bar–Store	  Mon–Fri: Lunch, Dinner  |  Sun: Brunch/Lunch, Dinner 
Bar Boulud	  Mon–Fri: Lunch, Dinner  | Sun Dinner
Cherche Midi	  Mon–Fri: Lunch, Dinner  | Sun Dinner
Thalassa Restaurant	  Mon–Fri: Lunch, Dinner 
Michael's Restaurant	  Mon–Fri: Lunch, Dinner 
Monkey Bar	  Mon–Fri: Lunch, Dinner 
The Clocktower	 Mon-Fri Lunch
Fig & Olive—Downtown	  Mon–Fri: Lunch, Dinner  |  Sun: Brunch/Lunch, Dinner 
Bocca Di Bacco—Hell's Kitchen	  Mon–Fri: Lunch, Dinner  |  Sun: Brunch/Lunch, Dinner 
Calle Ocho	 Mon-Fri Dinner | Sun Dinner
Darbar Grill	 Mon-Fri Dinner | Sun Dinner
Mercer Kitchen	  Mon–Fri: Lunch, Dinner  | Sun Dinner
Gallaghers Steakhouse	 Mon-Fri Lunch | Sun Brunch/Lunch
MP Taverna - Astoria	  Mon–Fri: Lunch, Dinner  |  Sun: Brunch/Lunch, Dinner 
Sushi Seki Times Square	 Mon-Fri Lunch
Nougatine at Jean-Georges	  Mon–Fri: Lunch, Dinner  | Sun Dinner
Club A Steakhouse	 Mon-Fri Dinner
FishTag	 Mon-Fri Dinner |  Sun: Brunch/Lunch, Dinner 
The Water Club	 Mon-Fri Dinner |  Sun: Brunch/Lunch, Dinner 
Boulud Sud	  Mon–Fri: Lunch, Dinner  | Sun Dinner
Left Bank	 Mon-Fri Dinner | Sun Dinner
Bodega Negra at Dream Downtown	 Mon-Fri Dinner | Sun Dinner
Pera SoHo	  Mon–Fri: Lunch, Dinner  |  Sun: Brunch/Lunch, Dinner 
DBGB Kitchen and Bar	  Mon–Fri: Lunch, Dinner  | Sun Dinner
Café Boulud	 Mon-Fri Lunch
Hearth	 Mon-Fri Dinner | Sun Dinner
Kristalbelli	 Mon-Fri Dinner
Lupa Osteria Romana	 Mon-Fri Lunch
DB Bistro Moderne	  Mon–Fri: Lunch, Dinner  | Sun Dinner
Chez Josephine	  Mon–Fri: Lunch, Dinner  | Sun Dinner
Bedford & Co.	  Mon–Fri: Lunch, Dinner  |  Sun: Brunch/Lunch, Dinner 
Sarabeth's Upper East Side	  Mon–Fri: Lunch, Dinner  | Sun Dinner
ViceVersa	  Mon–Fri: Lunch, Dinner  | Sun Dinner
Danji	  Mon–Fri: Lunch, Dinner  | Sun Brunch/Lunch
Quality Eats	 Mon-Fri Lunch
Park Avenue Winter	  Mon–Fri: Lunch, Dinner  | Sun Dinner
Parlor Steak & Fish	  Mon–Fri: Lunch, Dinner  | Sun Dinner
Morrell Wine Bar & Cafe	  Mon–Fri: Lunch, Dinner  |  Sun: Brunch/Lunch, Dinner 
Bobby Van's Grill - West 45th Street	  Mon–Fri: Lunch, Dinner  | Sun Dinner
Atrio Wine Bar l Restaurant	  Mon–Fri: Lunch, Dinner  | Sun Dinner
Rossini's Restaurant	  Mon–Fri: Lunch, Dinner  | Sun Dinner
Beaubourg at Le District	  Mon–Fri: Lunch, Dinner 
Le Cirque	  Mon–Fri: Lunch, Dinner 
Bobby Van's Grill - West 50th Street	  Mon–Fri: Lunch, Dinner  | Sun Dinner
Villa Berulia	  Mon–Fri: Lunch, Dinner 
Bobby Van's Steakhouse & Grill - Broad Street	  Mon–Fri: Lunch, Dinner 
Smith & Wollensky	 Mon-Fri Lunch
Nice Matin	  Mon–Fri: Lunch, Dinner  | Sun Dinner
Tarallucci e Vino—NoMad	  Mon–Fri: Lunch, Dinner  |  Sun: Brunch/Lunch, Dinner 
Pampano	  Mon–Fri: Lunch, Dinner  | Sun Dinner
Empellón Taqueria	  Mon–Fri: Lunch, Dinner  |  Sun: Brunch/Lunch, Dinner 
Benchmark Restaurant	  Mon–Fri: Lunch, Dinner  |  Sun: Brunch/Lunch, Dinner 
Artie's Steak and Seafood	  Mon–Fri: Lunch, Dinner  | Sun Dinner
Vermilion	  Mon–Fri: Lunch, Dinner 
The Dutch	 Mon-Fri Lunch
Taboon	 Mon-Fri Dinner | Sun Dinner
Tulsi	  Mon–Fri: Lunch, Dinner  | Sun Dinner
Lafayette	  Mon–Fri: Lunch, Dinner  | Sun Dinner
Penthouse 808 	 Mon-Fri Dinner | Sun Dinner
Angus Club Steakhouse	  Mon–Fri: Lunch, Dinner  | Sun Dinner
T Bar Steak and Lounge	  Mon–Fri: Lunch, Dinner  | Sun Dinner
Megu	 Mon-Fri Dinner | Sun Dinner
Haru Third Avenue	  Mon–Fri: Lunch, Dinner 
Felice 64	  Mon–Fri: Lunch, Dinner  | Sun Dinner
Sarabeth's Central Park South	  Mon–Fri: Lunch, Dinner  | Sun Dinner
Hudson Garden Grill 	 Mon-Fri Lunch
Maloney & Porcelli	 Mon-Fri Dinner | Sun Dinner
Marseille	  Mon–Fri: Lunch, Dinner  | Sun Dinner
The Lambs Club Bar	  Mon–Fri: Lunch, Dinner 
Il Cantinori Restaurant	  Mon–Fri: Lunch, Dinner  | Sun Dinner
Rocking Horse Cafe	  Mon–Fri: Lunch, Dinner 
Pig and Khao	 Mon-Fri Dinner |  Sun: Brunch/Lunch, Dinner 
Savore Ristorante	  Mon–Fri: Lunch, Dinner  |  Sun: Brunch/Lunch, Dinner 
Paul's on Times Square	  Mon–Fri: Lunch, Dinner  |  Sun: Brunch/Lunch, Dinner 
The Writing Room	 Mon-Fri Dinner | Sun Dinner
Masseria Dei Vini	  Mon–Fri: Lunch, Dinner  |  Sun: Brunch/Lunch, Dinner 
Jue Lan Club	  Mon–Fri: Lunch, Dinner  |  Sun: Brunch/Lunch, Dinner 
Grotta Azzurra Restaurant	  Mon–Fri: Lunch, Dinner  |  Sun: Brunch/Lunch, Dinner 
Armani/Ristorante	 Mon-Fri Dinner | Sun Brunch/Lunch
Frankie & Johnnie’s Steakhouse—37th Street	  Mon–Fri: Lunch, Dinner 
Sarabeth's Park Avenue South	  Mon–Fri: Lunch, Dinner  | Sun Dinner
High Street on Hudson	  Mon–Fri: Lunch, Dinner  | Sun Dinner
Hanjan	  Mon–Fri: Lunch, Dinner 
Acme	 Mon-Fri Dinner |  Sun: Brunch/Lunch, Dinner 
La Masseria	  Mon–Fri: Lunch, Dinner  |  Sun: Brunch/Lunch, Dinner 
Craftbar	  Mon–Fri: Lunch, Dinner  | Sun Dinner
New Leaf Restaurant & Bar	  Mon–Fri: Lunch, Dinner  |  Sun: Brunch/Lunch, Dinner 
Baita at La Birreria	  Mon–Fri: Lunch, Dinner 
i Trulli Ristorante/Enoteca	  Mon–Fri: Lunch, Dinner  | Sun Dinner
Murray's Cheese Bar	 Mon-Fri Dinner | Sun Dinner
Perrine	  Mon–Fri: Lunch, Dinner  | Sun Dinner
Maiella	 Mon-Fri Dinner | Sun Dinner
Casa Mono & Bar Jamón	 Mon-Fri Lunch
Periyali	  Mon–Fri: Lunch, Dinner  | Sun Dinner
Cipriani Dolci	  Mon–Fri: Lunch, Dinner  |  Sun: Brunch/Lunch, Dinner 
Remi Restaurant	  Mon–Fri: Lunch, Dinner  | Sun Dinner
2 West	  Mon–Fri: Lunch, Dinner 
Nino's Restaurant	  Mon–Fri: Lunch, Dinner  | Sun Dinner
Oro	 Mon-Fri Dinner
Bocca Di Bacco—Chelsea	  Mon–Fri: Lunch, Dinner  |  Sun: Brunch/Lunch, Dinner 
Hatsuhana Sushi Restaurant	  Mon–Fri: Lunch, Dinner 
Becco	 Mon-Fri Lunch | Sun Brunch/Lunch
Reserve Cut	 Mon-Fri Lunch
Bocca Di Bacco—Theatre District	  Mon–Fri: Lunch, Dinner  |  Sun: Brunch/Lunch, Dinner 
Café D'Alsace	  Mon–Fri: Lunch, Dinner  | Sun Dinner
Restaurant Nippon	  Mon–Fri: Lunch, Dinner 
MarkJoseph Steakhouse	  Mon–Fri: Lunch, Dinner  | Sun Dinner
Kingsley	 Mon-Fri Dinner
Zio Ristorante	  Mon–Fri: Lunch, Dinner  | Sun Dinner
Le Coq Rico	 Mon-Fri Lunch
Arlington Club	 Mon-Fri Dinner | Sun Dinner
Bobby Van's Steakhouse - East 54th Street	  Mon–Fri: Lunch, Dinner 
Scaletta Ristorante	 Mon-Fri Dinner | Sun Dinner
Todd English Food Hall	  Mon–Fri: Lunch, Dinner  | Sun Dinner
Bobo	 Mon-Fri Dinner
Zero Otto Nove	  Mon–Fri: Lunch, Dinner  | Sun Dinner
Shun Lee Palace	 Mon-Fri Lunch
Little Park	 Mon-Fri Lunch
Esca	 Mon-Fri Lunch
Fino Ristorante Italiano	  Mon–Fri: Lunch, Dinner 
Distilled NY	 Mon-Fri Dinner |  Sun: Brunch/Lunch, Dinner 
Bello Restaurant	  Mon–Fri: Lunch, Dinner  | Sun Dinner
Eolo: Seasonal Sicilian Kitchen	  Mon–Fri: Lunch, Dinner  |  Sun: Brunch/Lunch, Dinner 
Maison Hugo	  Mon–Fri: Lunch, Dinner  |  Sun: Brunch/Lunch, Dinner 
Almayass	  Mon–Fri: Lunch, Dinner  |  Sun: Brunch/Lunch, Dinner 
Narcissa	 Mon-Fri Dinner
Da Noi - Midtown Manhattan	  Mon–Fri: Lunch, Dinner  | Sun Dinner
Bocca Restaurant & Bar	  Mon–Fri: Lunch, Dinner  | Sun Dinner
Nino's Tuscany Steakhouse	  Mon–Fri: Lunch, Dinner  | Sun Dinner
